#domain
hospital
#levelname
BoxBoxBox
#colors
red: 0, P, B, H, R, A, S, E, U
#initial
+++++++++++
++++P+B++++
++++ + ++++
++++ + ++++
+H 0     R+
++++ + ++++
+A       S+
++++ + ++++
++++ + ++++
++++E+U++++
+++++++++++
#goal
+++++++++++
++++ + ++++
++++ + ++++
++++ + ++++
+   UBE   +
++++P+S++++
+   RAH   +
++++ + ++++
++++ + ++++
++++ + ++++
+++++++++++
#end
