#domain
hospital
#levelname
CleaningCrewCleanHarder
#colors
red: 0, A
blue: 1, B, C, D, E
#initial
++++++++++++++++++++++
++++++++++ +++ +++ +++
+0A          BCDE 1  +
++++++++++++ +++ +++++
++++++++++++++++++++++
#goal
++++++++++++++++++++++
++++++++++ +++ +++ +++
+                   A+
++++++++++++ +++ +++++
++++++++++++++++++++++
#end
