#domain
hospital
#levelname
CleaningCrew
#colors
red: 0, A
blue: 1, B, C, D, E
#initial
+++++++++++++++++++
++++++++++++++ ++++
+0A       1  B    +
++++++++++++ ++++++
+++++++++++++++++++
#goal
+++++++++++++++++++
++++++++++++++ ++++
+                A+
++++++++++++ ++++++
+++++++++++++++++++
#end
