#domain
hospital
#levelname
MAExponentialSearch
#colors
red: 0, A, B
blue: 1, C, D
#initial
++++++++++++
+0 A      1+
+          +
+B         +
+         C+
+        D +
++++++++++++
#goal
++++++++++++
+          +
+          +
+          +
+          +
+         A+
++++++++++++
#end
