#domain
hospital
#levelname
NastyConflict
#colors
red: 0, A
pink: 1, B
blue: 2, C
#initial
++++++++++++++++
+++++++0++++++++
+++++++A++++++++
+++++++ ++++++++
+++++++ ++++++++
+++++++ ++++++++
+++++++ ++++++++
+1B            +
+++++++ ++++++++
+++++++ ++++++++
+++++++ ++++++++
+++++++ ++++++++
+++++++C++++++++
+++++++2++++++++
++++++++++++++++
#goal
++++++++++++++++
+++++++ ++++++++
+++++++ ++++++++
+++++++ ++++++++
+++++++ ++++++++
+++++++ ++++++++
+++++++ ++++++++
+           ABC+
+++++++ ++++++++
+++++++ ++++++++
+++++++ ++++++++
+++++++ ++++++++
+++++++ ++++++++
+++++++ ++++++++
++++++++++++++++
#end
