#domain
hospital
#levelname
PriorityStupid
#colors
red: 0, A, C, E, G, I
blue: 1, B, D, F, H
#initial
+++++++++++++++++++++++
+ACEGI  +++   +++ HFDB+
+0                   1+
+       +++   +++     +
+++++++++++++++++++++++
#goal
+++++++++++++++++++++++
+       +++ABC+++     +
+          DEF        +
+       +++GIH+++     +
+++++++++++++++++++++++
#end
