#domain
hospital
#levelname
Priority
#colors
red: 0, A, B, C, D, E, F
#initial
+++++++++++++++
+ABCDEF++++++++
+0            +
+      ++++++++
+++++++++++++++
#goal
+++++++++++++++
+      ++++++++
+       ABCDEF+
+      ++++++++
+++++++++++++++
#end
