#domain
hospital
#levelname
PriorityTester
#colors
red: 0, A, B, C, D, E, F, G, H, I, J
#initial
++++++++++++++++++
+ABCDEFGHI+++   ++
+0              J+
+         +++   ++
++++++++++++++++++
#goal
++++++++++++++++++
+         +++ABC++
+         J  DEF +
+         +++GHI++
++++++++++++++++++
#end
