#domain
hospital
#levelname
PriorityStupid
#colors
red: 0, A, B, C, D, E, F, G, H, I
#initial
++++++++++++++++++
+ABC EFGHI+++   ++
+0              D+
+         +++   ++
++++++++++++++++++
#goal
++++++++++++++++++
+         +++ABC++
+            DEF +
+         +++GHI++
++++++++++++++++++
#end
