#domain
hospital
#levelname
SameColor
#colors
red: 0, 1, A, B
#initial
++++++++++++
+  B A 1 +0+
+ +++++++  +
+          +
++++++++++++
#goal
++++++++++++
+       A+ +
+ +++++++  +
+          +
++++++++++++
#end
