#domain
hospital
#levelname
PriorityStupid
#colors
red: 0, A, B
#initial
++++++++++++
+B ++++++ A+
+0         +
+  ++++++  +
++++++++++++
#goal
++++++++++++
+  ++++++  +
+    AB    +
+  ++++++  +
++++++++++++
#end
