#domain
hospital
#levelname
TowersOfRandom
#colors
red: 0, A, B, C, D, E
blue: 1, F, G, H, I, J
green: 2, K, L, M, N, O
cyan: 3, P, Q, R, S, T
pink: 4, U, V, W, X, Y
#initial
+++++++++++++++++++++++
+ 0   1    2    3   4 +
+G+ +L+ +Q+ + +V+ +B+ +
+N+ +S+ +X+ + +D+ +I+ +
+P+ +U+ +A+ + +F+ +K+ +
+W+ +C+ +H+ + +M+ +R+ +
+E+ +J+ +O+ + +T+ +Y+ +
+++++++++++++++++++++++
#goal
+++++++++++++++++++++++
+                     +
+ +A+ +F+ + +K+ +P+ +U+
+ +B+ +G+ + +L+ +Q+ +V+
+ +C+ +H+ + +M+ +R+ +W+
+ +D+ +I+ + +N+ +S+ +X+
+ +E+ +J+ + +O+ +T+ +Y+
+++++++++++++++++++++++
#end
